#######
#   #F#
# # # #
#S#   #
#######