####################################### 
# S     #             #               # 
#   #   #   #######   #   #########   # 
#   #   #   #     #   #   #       #   # 
#   #   #   #   # #   #   #   #   #   # 
#   #   #   #   # F   #   #   #   #   # 
#   #   #   #   #######   #   #   #   # 
#   #   #   #             #   #   #   # 
#   #   #   ###############   #   #   # 
#   #   #                     #   #   # 
#   #   #######################   #   # 
#   #                             #   # 
#   ###############################   # 
#                                     # 
#######################################
#######################################